b w w w w w w b b 
w w b w w b w b w 
b g b b w b w w w 
w w w b w w w w s 
w w w b w w w b w 
w b w b b w w b w 
b b w w b b w w w 
b w w w w w w w w 
b w w w w w w w b 
